11111111111111111111111111111
10000000000000000000000000001
1C000111110000000C00000000001
1000000000E000000000000000001
1000P0000000C0000000000000111
1000000C0000000000000000000C1
11111111111111111111111111111
